As an accomplished detective you are able to mentally simulate how the Crowther Engine must have been stolen. You begin by imagining yourself in the role of the thief.

The thief would have had to complete his mission before Blitzen Crowther returned to the laboratory at sunrise, 6:00 am.

The Crowther Engine Heist
An Interactive Fiction by Kieren Davies
Release 1 / Serial number 121025 / Inform 7 build 6G60 (I6/v6.32 lib 6/12N) SD

Shielded Corridor
Outside the Laboratories of the Worthy Order of Curmudgeons, the walls are shielded with sonic damping, fire proofing, acid-resistant lacquer, structural supports and storm baffling. (The last a recent addition inspired by Dr Crowther's experiments). The Cogway, the imposing entrance to the Prime Laboratory, is in the south wall.

You can see the Cogway and a Lustrous Key here.

>take key
Taken.

Your pocket watch reads 5:40 am.

>unlock cogway
(with Lustrous Key)
You unlock the Cogway.

Your pocket watch reads 5:41 am.

>open cogway
You open the Cogway.

Your pocket watch reads 5:42 am.

>go south
Prime Laboratory
This massive barrel-vaulted chamber is clustered with half a dozen ongoing experiments. Sparks surge between twisted prongs, sulphurous liquids bubble and murmur, and a half-made automaton rocks itself back and forth in the corner. The hair on the back of your neck rises. This could be from the terrible portent of the experiments conducted here over the centuries or it could be from the actinic charge in the air.

Crowther's Lab is to the west and the Insectarium is to the east. An archway leads south to the flight platform and is also useful for venting in an emergency.

You can see the Cogway, a Rail (on which is a Daedulus Flutter-wing (empty)), the Slow Glass, some Arcane Paraphernalia (closed) and a Storm Globes here.

>go west
Crowther Lab
The walls of this spherical room are tiled in brass and streaked with soot from Dr Crowther's lightning experiments, but now it is dominated by the Crowther Engine.

You can see the Crowther Engine (in which is a Punch Card) and a Brass Man here.

>take crowther engine
Taken.

>go east
Prime Laboratory
This massive barrel-vaulted chamber is clustered with half a dozen ongoing experiments. Sparks surge between twisted prongs, sulphurous liquids bubble and murmur, and a half-made automaton rocks itself back and forth in the corner. The hair on the back of your neck rises. This could be from the terrible portent of the experiments conducted here over the centuries or it could be from the actinic charge in the air.

Crowther's Lab is to the west and the Insectarium is to the east. An archway leads south to the flight platform and is also useful for venting in an emergency.

You can see the Cogway, a Rail (on which is a Daedulus Flutter-wing (empty)), the Slow Glass, some Arcane Paraphernalia (closed) and a Storm Globes here.

>go south
Launch Platform
Bleh.

You can see a Tower Wall here.

>go up
Balloon Mooring
You can see a Hot-Air Balloon (empty) here.

>showme
Balloon Mooring - room
    Surrounding Forest - backdrop
    yourself - person
        Crowther Engine - open container
            Punch Card
        Lustrous Key
    Hot-Air Balloon - vehicle

>enter hot-air balloon
You get into the Hot-Air Balloon.

>showme
Balloon Mooring - room
    Surrounding Forest - backdrop
    Hot-Air Balloon - vehicle
        yourself - person
            Crowther Engine - open container
                Punch Card
            Lustrous Key

>leave balloon
I only understood you as far as wanting to leave.

>leave hot-air balloon
I only understood you as far as wanting to leave.

>exit hot-air balloon
I only understood you as far as wanting to exit.

>help
That's not a verb I recognise.

>fly
That's not a verb I recognise.

>drive
That's not a verb I recognise.

>ride
That's not a verb I recognise.

>go down
Launch Platform (in the Hot-Air Balloon)
Bleh.

You can see a Tower Wall here.

>do down
That's not a verb I recognise.

>go down
(first opening the Tower Wall)
It seems to be locked.

>open
What do you want to open?

>open door
You can't see any such thing.

>showme
Launch Platform - room
    Surrounding Forest - backdrop
    Hot-Air Balloon - vehicle
        yourself - person
            Crowther Engine - open container
                Punch Card
            Lustrous Key
    Tower Wall - locked door

>open tower wall
It seems to be locked.

* * *

>take key
Taken.

Your pocket watch reads 5:40 am.

>unlock cogway
(with Lustrous Key)
You unlock the Cogway.

>open cogway
You open the Cogway.

>go south
Prime Laboratory
This massive barrel-vaulted chamber is clustered with half a dozen ongoing experiments. Sparks surge between twisted prongs, sulphurous liquids bubble and murmur, and a half-made automaton rocks itself back and forth in the corner. The hair on the back of your neck rises. This could be from the terrible portent of the experiments conducted here over the centuries or it could be from the actinic charge in the air.

Crowther's Lab is to the west and the Insectarium is to the east. An archway leads south to the flight platform and is also useful for venting in an emergency.

You can see the Cogway, a Rail (on which is a Daedulus Flutter-wing (empty)), the Slow Glass, some Arcane Paraphernalia (closed) and a Storm Globes here.

>take tesla gun
You can't see any such thing.

>open paraphernalia
They're not something you can open.

>inspect paraphernalia
That's not a verb I recognise.

>examinparaphernalia
That's not a verb I recognise.

>examine paraphernalia
The detritus of half a hundred failed experiments. There might be something salvageable in here if your are prepared to risk rummaging.

>rummage
That's not a verb I recognise.

>open paraphernalia
They're not something you can open.

>showme
Prime Laboratory - room
    Cogway - open door
    yourself - person
        Lustrous Key
    Rail - supporter
        Daedulus Flutter-wing - vehicle
    Slow Glass
    Arcane Paraphernalia - closed container
        *spider-silk rope
        *perpetual machine
        *Tesla gun
    Storm Globes
* denotes things which are not in scope

* * *

I beg your pardon?

* * *

>wait
Time passes.

Your pocket watch reads 5:40 am.

>wait
Time passes.

Your pocket watch reads 5:41 am.

>wait
Time passes.

Your pocket watch reads 5:42 am.

>wait
Time passes.

Your pocket watch reads 5:43 am.

>wait
Time passes.

Your pocket watch reads 5:44 am.

>wait
Time passes.

Your pocket watch reads 5:45 am.

>wait
Time passes.

Your pocket watch reads 5:46 am.

>wait
Time passes.

Your pocket watch reads 5:47 am.

>wait
Time passes.

Your pocket watch reads 5:48 am.

>wait
Time passes.

Your pocket watch reads 5:49 am.

>wait
Time passes.

Your pocket watch reads 5:50 am.

>wait
Time passes.

Your pocket watch reads 5:51 am.

>wait
Time passes.

Your pocket watch reads 5:52 am.

>wait
Time passes.

Your pocket watch reads 5:53 am.

>wait
Time passes.

Your pocket watch reads 5:54 am.

>wait
Time passes.

Your pocket watch reads 5:55 am.

>wait
Time passes.

Your pocket watch reads 5:56 am.

>wait
Time passes.

Your pocket watch reads 5:57 am.

>wait
Time passes.

Your pocket watch reads 5:58 am.

>wait
Time passes.

Your pocket watch reads 5:59 am.

>wait
Time passes.

Your pocket watch reads 6:00 am.

    *** The cock crows with the sunrise, and Crowther's voice approaches as he murmurs to himself. Upon seeing this intruder he quickly pulls an electric weapon from his coat and fires a fatal shot. ***

In that game you scored 0 out of a possible 0, in 21 turns.

Would you like to RESTART, RESTORE a saved game, QUIT or UNDO the last command?

>quit
[ The game has finished ]

* * *

>test correct
(Testing.)

>[1] test sc
(Testing.)

>[2] take key
Taken.

Your pocket watch reads 5:40 am.

>[3] unlock cogway
(with the Lustrous Key)
You unlock the Cogway.

Your pocket watch reads 5:41 am.

>[4] open cogway
You open the Cogway.

Your pocket watch reads 5:42 am.

>[5] go south

Prime Laboratory
This massive barrel-vaulted chamber is clustered with half a dozen ongoing experiments. Sparks surge between twisted prongs, sulphurous liquids bubble and murmur, and a half-made automaton rocks itself back and forth in the corner. The hair on the back of your neck rises. This could be from the terrible portent of the experiments conducted here over the centuries or it could be from the actinic charge in the air.

Crowther's Lab is to the west and the Insectarium is to the east. An archway leads south to the flight platform and is also useful for venting in an emergency.

You can see the Cogway, a Rail (on which is a Daedulus Flutter-wing (empty)), the Slow Glass, a Storm Globes and some Arcane Paraphernalia (closed) here.

Your pocket watch reads 5:43 am.

* * *

>showme
Balloon Mooring - room
    Crowther Engine - open container
        Punchcards
    Brass Man - device
    Surrounding Forest - backdrop
    yourself - person
        Punch
        Beaker - open container
        Lustrous Key
    Hot-Air Balloon - vehicle

>throw key
Dropped.

Your pocket watch reads 5:44 am.

* * *

>showme
Balloon Mooring - room
    Crowther Engine - open container
        Punchcards
    Brass Man - device
    Surrounding Forest - backdrop
    yourself - person
        Punch
        Beaker - open container
        Lustrous Key
    Hot-Air Balloon - vehicle

>switch on brass man
You switch the Brass Man on.

Your pocket watch reads 5:48 am.

* * *

>showme
Balloon Mooring - room
    Crowther Engine - open container
        Punchcards
    Brass Man - device
    Surrounding Forest - backdrop
    yourself - person
        Punch
        Beaker - open container
        Lustrous Key
    Hot-Air Balloon - vehicle

>inventory
You are carrying:
  a Water
  a Beaker
  a Lustrous Key

Your pocket watch reads 5:50 am.

>examine beaker
The Beaker is empty.

Your pocket watch reads 5:51 am.

* * *

>showme
Balloon Mooring - room
    Crowther Engine - open container
        Punchcards
    Brass Man - device
    Surrounding Forest - backdrop
    yourself - person
        Punch
        Beaker - open container
        Lustrous Key
    Hot-Air Balloon - vehicle

>inventoy
That's not a verb I recognise.

>inventory
You are carrying:
  a Punch
  a Beaker
    some Water
  a Lustrous Key

Your pocket watch reads 5:55 am.

* * *

>showme
Balloon Mooring - room
    Crowther Engine - open container
        Punchcards
    Brass Man - device
    Surrounding Forest - backdrop
    yourself - person
        Punch
        Beaker - open container
        Lustrous Key
    Hot-Air Balloon - vehicle

>put water in brass man
That can't contain things.

Your pocket watch reads 5:55 am.

>take water
Your pocket watch reads 5:56 am.

>put water in brass man
(first taking the Water)

Your pocket watch reads 5:57 am.

>showme
Crowther Lab - room
    yourself - person
        Punch
        Beaker - open container
            Water
        Lustrous Key
    Crowther Engine - open container
        Punchcards
    Brass Man - device

* * *

>showme
Balloon Mooring - room
    Crowther Engine - open container
        Punchcards
    Brass Man - device
    Surrounding Forest - backdrop
    yourself - person
        Punch
        Beaker - open container
        Lustrous Key
    Hot-Air Balloon - vehicle

>switch brass man on
You switch the Brass Man on.

on.
Your pocket watch reads 5:45 am.

>showme
Crowther Lab - room
    yourself - person
        Punch
        Beaker - open container
        Lustrous Key
    Crowther Engine - open container
        Punchcards
    Brass Man - device
    Funnel - open container
        Water

* * *

>showme
Balloon Mooring - room
    Crowther Engine - open container
        Punchcards
    Brass Man - device
    Surrounding Forest - backdrop
    yourself - person
        Punch
        Beaker - open container
        Lustrous Key
    Hot-Air Balloon - vehicle

>down
Launch Platform
This precarious wooden ramp is where Peabody launches his flying machines, usually to Orvell's detriment. Above is a ladder to a small platform where a hot-air balloon is moored. The tower wall below has a retractable stone staircase down to the ground. Below the tower you can see a donkey cart.

The staircase is retracted and unfortunately the activation mechanism is missing its crank handle.

The Brass Man noisily drags the Crowther Engine along behind you.
Your pocket watch reads 5:50 am.

>n
Prime Laboratory
This massive barrel-vaulted chamber is clustered with half a dozen ongoing experiments. Sparks surge between twisted prongs, sulphurous liquids bubble and murmur, and a half-made automaton rocks itself back and forth in the corner. The hair on the back of your neck rises. This could be from the terrible portent of the experiments conducted here over the centuries or it could be from the actinic charge in the air.

Crowther's Lab is to the west and the Insectarium is to the east. An archway leads south to the flight platform and is also useful for venting in an emergency.

You can see the Cogway, a Rail (on which is a Daedulus Flutter-wing (empty)), the Slow Glass and some Arcane Paraphernalia (closed) here.

The Brass Man noisily drags the Crowther Engine along behind you.
Your pocket watch reads 5:51 am.

>w
Crowther Lab
The walls of this spherical room are tiled in brass and streaked with soot from Dr Crowther's lightning experiments, but now it is dominated by the Crowther Engine.

You can see a Funnel (in which is some Water) here.

The Brass Man noisily drags the Crowther Engine along behind you.
Your pocket watch reads 5:52 am.

>showme
Crowther Lab - room
    Crowther Engine - open container
        Punchcards
    Brass Man - device
    yourself - person
        Punch
        Beaker - open container
        Lustrous Key
    Funnel - open container
        Water

* * *

>n
Prime Laboratory
This massive barrel-vaulted chamber is clustered with half a dozen ongoing experiments. Sparks surge between twisted prongs, sulphurous liquids bubble and murmur, and a half-made automaton rocks itself back and forth in the corner. The hair on the back of your neck rises. This could be from the terrible portent of the experiments conducted here over the centuries or it could be from the actinic charge in the air.

Crowther's Lab is to the west and the Insectarium is to the east. An archway leads south to the flight platform and is also useful for venting in an emergency.

You can see the Cogway, a Rail (on which is a Daedulus Flutter-wing (empty)), the Slow Glass and some Arcane Paraphernalia (closed) here.

The Brass Man noisily drags the Crowther Engine along behind you.
Your pocket watch reads 5:50 am.

>search paraphernalia
You can't see inside, since the Arcane Paraphernalia are closed.

on.
Your pocket watch reads 5:51 am.

* * *

>search
What do you want to search?

>search paraphernalia
You can't see inside, since the Arcane Paraphernalia are closed.

The Brass Man noisily drags the Crowther Engine along behind you.
Your pocket watch reads 5:51 am.

>open paraphernalia
You open the Arcane Paraphernalia, revealing a spider-silk rope, perpetual machine, crank handle and Tesla gun.

The Brass Man noisily drags the Crowther Engine along behind you.
Your pocket watch reads 5:52 am.

* * *

>showme
Shielded Corridor - room
    Cogway - locked door
    yourself - person
    Lustrous Key

>test me
(Testing.)

>[1] test sc
(Testing.)

>[2] take key
Taken.

Your pocket watch reads 5:40 am.

>[3] unlock cogway
(with the Lustrous Key)
You unlock the Cogway.

Your pocket watch reads 5:41 am.

>[4] open cogway
You open the Cogway.

Your pocket watch reads 5:42 am.

>[5] go south

Prime Laboratory
This massive barrel-vaulted chamber is clustered with half a dozen ongoing experiments. Sparks surge between twisted prongs, sulphurous liquids bubble and murmur, and a half-made automaton rocks itself back and forth in the corner. The hair on the back of your neck rises. This could be from the terrible portent of the experiments conducted here over the centuries or it could be from the actinic charge in the air.

Crowther's Lab is to the west and the Insectarium is to the east. An archway leads south to the flight platform and is also useful for venting in an emergency.

You can see the Cogway, a Rail (on which is a Daedulus Flutter-wing (empty)), the Slow Glass, a Storm Globes and some Arcane Paraphernalia (closed) here.

Your pocket watch reads 5:43 am.

>take storm globe
I only understood you as far as wanting to take the Storm Globes.

>take storm globes
Taken.

Your pocket watch reads 5:44 am.

>go w
Crowther Lab
The walls of this spherical room are tiled in brass and streaked with soot from Dr Crowther's lightning experiments, but now it is dominated by the Crowther Engine.

You can see the Crowther Engine (empty), a Punch, a Punch Cards and a Brass Man here.

Your pocket watch reads 5:45 am.

>go e
Prime Laboratory
This massive barrel-vaulted chamber is clustered with half a dozen ongoing experiments. Sparks surge between twisted prongs, sulphurous liquids bubble and murmur, and a half-made automaton rocks itself back and forth in the corner. The hair on the back of your neck rises. This could be from the terrible portent of the experiments conducted here over the centuries or it could be from the actinic charge in the air.

Crowther's Lab is to the west and the Insectarium is to the east. An archway leads south to the flight platform and is also useful for venting in an emergency.

You can see the Cogway, a Rail (on which is a Daedulus Flutter-wing (empty)), the Slow Glass and some Arcane Paraphernalia (closed) here.

Your pocket watch reads 5:46 am.

>go e
Clockwork Insectarium
This room is filled with twisted metal and stained glass constructs in a caricature of a jungle environment. Oversized clockwork beetles, worms, butterflies and spiders move sluggishly among the synthetic foliage. A stained glass doorway leads west back to the main laboratory.

You can see the clockwork insects here.

Your pocket watch reads 5:47 am.

>throw globe
You can't see any such thing.

>throw globes
splodes!

Your pocket watch reads 5:48 am.

>take globes
Taken.

Your pocket watch reads 5:49 am.

>go w
Prime Laboratory
This massive barrel-vaulted chamber is clustered with half a dozen ongoing experiments. Sparks surge between twisted prongs, sulphurous liquids bubble and murmur, and a half-made automaton rocks itself back and forth in the corner. The hair on the back of your neck rises. This could be from the terrible portent of the experiments conducted here over the centuries or it could be from the actinic charge in the air.

Crowther's Lab is to the west and the Insectarium is to the east. An archway leads south to the flight platform and is also useful for venting in an emergency.

You can see the Cogway, a Rail (on which is a Daedulus Flutter-wing (empty)), the Slow Glass and some Arcane Paraphernalia (closed) here.

Your pocket watch reads 5:50 am.

>throw globes
Your pocket watch reads 5:51 am.

* * *

>showme
Shielded Corridor - room
    Cogway - locked door
    yourself - person
    Lustrous Key

>i
You are carrying nothing.

Your pocket watch reads 5:30 am.

>sm
That's not a verb I recognise.

* * *

>test sc
(Testing.)

>[1] take key
Taken.

Your pocket watch reads 5:30 am.

>[2] unlock cogway
(with the Lustrous Key)
You unlock the Cogway.

Your pocket watch reads 5:31 am.

>[3] open cogway
You open the Cogway.

Your pocket watch reads 5:32 am.

>[4] go south

Prime Laboratory
This massive barrel-vaulted chamber is clustered with half a dozen ongoing experiments. Sparks surge between twisted prongs, sulphurous liquids bubble and murmur, and a half-made automaton rocks itself back and forth in the corner. The hair on the back of your neck rises. This could be from the terrible portent of the experiments conducted here over the centuries or it could be from the actinic charge in the air.

Crowther's Lab is to the west and the Insectarium is to the east. An archway leads south to the flight platform and is also useful for venting in an emergency.

You can see the Cogway, a Rail (on which is a Daedulus Flutter-wing (empty)), the Slow Glass, a Storm Globes, some Arcane Paraphernalia (in which are a spider-silk rope, perpetual machine and Tesla gun) and a Beaker (empty) here.

Your pocket watch reads 5:33 am.

>go east
Clockwork Insectarium
This room is filled with twisted metal and stained glass constructs in a caricature of a jungle environment. Oversized clockwork beetles, worms, butterflies and spiders move sluggishly among the synthetic foliage. A stained glass doorway leads west back to the main laboratory.

You can see the clockwork insects here.

Your pocket watch reads 5:44 am.

>take water
You can't see any such thing.

>w
Prime Laboratory
This massive barrel-vaulted chamber is clustered with half a dozen ongoing experiments. Sparks surge between twisted prongs, sulphurous liquids bubble and murmur, and a half-made automaton rocks itself back and forth in the corner. The hair on the back of your neck rises. This could be from the terrible portent of the experiments conducted here over the centuries or it could be from the actinic charge in the air.

Crowther's Lab is to the west and the Insectarium is to the east. An archway leads south to the flight platform and is also useful for venting in an emergency.

You can see the Cogway, a Rail (on which is a Daedulus Flutter-wing (empty)), the Slow Glass, a Storm Globes, some Arcane Paraphernalia (closed) and a Beaker (empty) here.

Your pocket watch reads 5:45 am.

>take storm globes
Taken.

Your pocket watch reads 5:46 am.

>e
Clockwork Insectarium
This room is filled with twisted metal and stained glass constructs in a caricature of a jungle environment. Oversized clockwork beetles, worms, butterflies and spiders move sluggishly among the synthetic foliage. A stained glass doorway leads west back to the main laboratory.

You can see the clockwork insects here.

Your pocket watch reads 5:47 am.

>throw storm globes
A thrown Storm Globe shatters, releasing the electric fury of the storm. The clockwork insects all move faster for a moment, and one of them suddenly explodes in a release of shrapnel.  Some of the thick foliage has been blown away to reveal a pool of water.

Your pocket watch reads 5:48 am.

>take water
How do you plan to hold that?

Your pocket watch reads 5:49 am.

>w
Prime Laboratory
This massive barrel-vaulted chamber is clustered with half a dozen ongoing experiments. Sparks surge between twisted prongs, sulphurous liquids bubble and murmur, and a half-made automaton rocks itself back and forth in the corner. The hair on the back of your neck rises. This could be from the terrible portent of the experiments conducted here over the centuries or it could be from the actinic charge in the air.

Crowther's Lab is to the west and the Insectarium is to the east. An archway leads south to the flight platform and is also useful for venting in an emergency.

You can see the Cogway, a Rail (on which is a Daedulus Flutter-wing (empty)), the Slow Glass, some Arcane Paraphernalia (closed) and a Beaker (empty) here.

Your pocket watch reads 5:50 am.

>take beaker
Taken.

Your pocket watch reads 5:51 am.

>e
Clockwork Insectarium
This room is filled with twisted metal and stained glass constructs in a caricature of a jungle environment. Oversized clockwork beetles, worms, butterflies and spiders move sluggishly among the synthetic foliage. A stained glass doorway leads west back to the main laboratory.

You can see a Water and the clockwork insects here.

Your pocket watch reads 5:52 am.

>put water in beaker
(first taking the Water)

How do you plan to hold that?

Your pocket watch reads 5:53 am.

* * *

>take beaker
Taken.

Your pocket watch reads 5:44 am.

* * *

>test ci
(Testing.)

>[1] take storm globes
Taken.

Your pocket watch reads 5:44 am.

>[2] take beaker
Taken.

Your pocket watch reads 5:45 am.

>[3] go east

Clockwork Insectarium
This room is filled with twisted metal and stained glass constructs in a caricature of a jungle environment. Oversized clockwork beetles, worms, butterflies and spiders move sluggishly among the synthetic foliage. A stained glass doorway leads west back to the main laboratory.

You can see the clockwork insects here.

Your pocket watch reads 5:46 am.

>[4] throw storm globes
A thrown Storm Globe shatters, releasing the electric fury of the storm. The clockwork insects all move faster for a moment, and one of them suddenly explodes in a release of shrapnel.  Some of the thick foliage has been blown away to reveal a pool of water.

Your pocket watch reads 5:47 am.

>[5] take water
Taken.

Your pocket watch reads 5:48 am.

>[6] go east
You can't go that way.

Your pocket watch reads 5:49 am.

* * *

>search paraphernalia
In the Arcane Paraphernalia are a spider-silk rope, perpetual machine and Tesla gun.

Your pocket watch reads 5:34 am.

* * *

>search paraphernalia
You can't see inside, since the Arcane Paraphernalia are closed.

on.
Your pocket watch reads 5:47 am.

>open paraphernalia
You open the Arcane Paraphernalia, revealing a spider-silk rope, perpetual machine, crank handle and Tesla gun.

on.
Your pocket watch reads 5:48 am.

* * *

>test donothing
(Testing.)

>[1] wait 30 minutes
I only understood you as far as wanting to wait.

>wait 30
I only understood you as far as wanting to wait.

>help wait
That's not a verb I recognise.

>help
That's not a verb I recognise.

>wait 2
I only understood you as far as wanting to wait.

>wait
Time passes.

Your pocket watch reads 5:30 am.

>wait
Time passes.

Your pocket watch reads 5:31 am.

>wait
Time passes.

Your pocket watch reads 5:32 am.

* * *

>test getcaught
(Testing.)

>[1] wait
Time passes.

Your pocket watch reads 5:30 am.

>[2] wait
Time passes.

Your pocket watch reads 5:31 am.

>[3] wait
Time passes.

Your pocket watch reads 5:32 am.

>[4] wait
Time passes.

Your pocket watch reads 5:33 am.

>[5] wait
Time passes.

Your pocket watch reads 5:34 am.

>[6] wait
Time passes.

Your pocket watch reads 5:35 am.

>[7] wait
Time passes.

Your pocket watch reads 5:36 am.

>[8] wait
Time passes.

Your pocket watch reads 5:37 am.

>[9] wait
Time passes.

Your pocket watch reads 5:38 am.

>[10] wait
Time passes.

Your pocket watch reads 5:39 am.

>[11] wait
Time passes.

Your pocket watch reads 5:40 am.

>[12] wait
Time passes.

Your pocket watch reads 5:41 am.

>[13] wait
Time passes.

Your pocket watch reads 5:42 am.

>[14] wait
Time passes.

Your pocket watch reads 5:43 am.

>[15] wait
Time passes.

Your pocket watch reads 5:44 am.

>[16] wait
Time passes.

Your pocket watch reads 5:45 am.

>[17] wait
Time passes.

Your pocket watch reads 5:46 am.

>[18] wait
Time passes.

Your pocket watch reads 5:47 am.

>[19] wait
Time passes.

Your pocket watch reads 5:48 am.

>[20] wait
Time passes.

Your pocket watch reads 5:49 am.

>[21] wait
Time passes.

Your pocket watch reads 5:50 am.

>[22] wait
Time passes.

Your pocket watch reads 5:51 am.

>[23] wait
Time passes.

Your pocket watch reads 5:52 am.

>[24] wait
Time passes.

Your pocket watch reads 5:53 am.

>[25] wait
Time passes.

Your pocket watch reads 5:54 am.

>[26] wait
Time passes.

Your pocket watch reads 5:55 am.

>[27] wait
Time passes.

Your pocket watch reads 5:56 am.

>[28] wait
Time passes.

Your pocket watch reads 5:57 am.

>[29] wait
Time passes.

Your pocket watch reads 5:58 am.

>[30] wait
Time passes.

Your pocket watch reads 5:59 am.

>[31] wait
Time passes.

Your pocket watch reads 6:00 am.

    *** The cock crows with the sunrise, and Crowther's murmuring voice approaches. He turns the corner and bellows, "You traitor!" He quickly pulls an electric weapon from his coat and fires a fatal shot. ***

Would you like to RESTART, RESTORE a saved game, QUIT or UNDO the last command?